Year,CSIRO Adjusted Sea Level,Lower Error,Upper Error
1880,0.0,-0.1,0.1
1881,0.03,-0.1,0.1
1882,0.06,-0.1,0.1
1883,0.08,-0.1,0.1
1884,0.1,-0.1,0.1
1885,0.12,-0.1,0.1
1886,0.14,-0.1,0.1
1887,0.17,-0.1,0.1
1888,0.19,-0.1,0.1
1889,0.21,-0.1,0.1
1890,0.23,-0.1,0.1
